vassal	واسال
diplomacy	دیپلماسی
Foreign Affairs	امور خارجه
Authority	اقتدار
chivalry	جوانمردی
Intrigue	دسیسه چینی
Skulduggery	فریبکاری
Temptation	اغواگری
Domain	مایملک	فعلا بهترین کلمه بنظرم همین هست
Stewardship	مدیریت	به کاربرد کلمه تو بازی همین مدیریت میخوره بنظرم
Intimidation	ارعاب
Seducer	اغواگر
lifestyle	سبک زندگی
Scheme	نقشه
Motte	قلعه چوبی
province	ایالت	؟
Traits	ویژگی
infant	نوزاد	شیرخوارگی
Raiders	محاجمان
Rank	رتبه
Balance	تعادل
Lowborn	بی اصل و نسب	Lowborn
